{
    "total_time": "10000",
    "9900": [
        {
            "x1": "200",
            "y1": "100",
            "x2": "250",
            "y2": "150",
            "type": "EnemyCommonB"
        },
        {
            "x1": "300",
            "y1": "100",
            "x2": "350",
            "y2": "150",
            "type": "EnemyCommonB"
        },
        {
            "x1": "400",
            "y1": "100",
            "x2": "450",
            "y2": "150",
            "type": "EnemyCommonB"
        }
    ],
    "9800": [
        {
            "x1": "200",
            "y1": "300",
            "x2": "250",
            "y2": "350",
            "type": "EnemyCommonA"
        },
        {
            "x1": "300",
            "y1": "300",
            "x2": "350",
            "y2": "350",
            "type": "EnemyCommonA"
        },
        {
            "x1": "400",
            "y1": "300",
            "x2": "450",
            "y2": "350",
            "type": "EnemyCommonA"
        }
    ],
    "9700": [
        {
            "x1": "200",
            "y1": "500",
            "x2": "250",
            "y2": "550",
            "type": "EnemyCommonB"
        },
        {
            "x1": "300",
            "y1": "500",
            "x2": "350",
            "y2": "550",
            "type": "EnemyCommonB"
        },
        {
            "x1": "400",
            "y1": "500",
            "x2": "450",
            "y2": "550",
            "type": "EnemyCommonB"
        }
    ]
}